1,1,1,1,1,1,1,1,1,1,1,1,1,1,1,1,1,1,1
1,1,1,1,1,1,1,1,1,1,1,1,1,1,1,1,1,1,1
11,11,11,11,11,11,11,11,11,11,11,11,11,11,11,11,11,11,11
11,11,11,11,11,11,11,11,11,11,11,11,11,11,11,11,11,11,11
9,9,9,9,9,9,9,9,9,9,9,9,9,9,9,9,9,9,9
14,14,14,14,14,14,14,14,14,14,14,14,14,14,14,14,14,14,14
8,8,8,8,8,8,8,8,8,8,8,8,8,8,8,8,8,8,8
12,12,12,12,12,12,12,12,12,12,12,12,12,12,12,12,12,12,12
1,1,1,1,1,1,1,1,1,1,1,1,1,1,1,1,1,1,1
13,13,13,13,13,13,13,13,13,13,13,13,13,13,13,13,13,13,13
11,11,11,11,11,11,11,11,11,11,11,11,11,11,11,11,11,11,11
17,17,17,17,17,17,17,16,16,16,16,16,16,16,16,16,16,16,16
9,9,9,9,9,9,9,9,9,9,9,9,9,9,9,9,9,9,9
11,11,11,11,11,11,11,11,11,11,11,11,11,11,11,11,11,11,11
17,17,17,17,17,17,17,17,17,17,17,17,17,17,16,16,16,16,16
17,17,17,17,17,17,17,17,17,17,17,17,17,17,17,17,17,17,17
12,12,12,12,12,12,12,12,12,12,12,12,12,12,12,12,12,12,12
13,16,13,13,13,13,13,13,13,13,13,13,13,13,13,13,13,13,13
21,18,21,21,21,21,21,21,21,21,21,21,21,21,21,21,21,21,21
14,14,14,14,14,14,14,14,14,14,14,14,14,14,14,14,14,14,14
2,2,2,2,2,2,2,2,3,3,3,4,4,4,4,4,4,4,4
1,1,1,1,1,1,1,1,1,1,1,1,1,1,1,1,1,1,1
18,18,18,18,18,18,18,18,18,18,18,18,18,18,18,18,18,18,18
4,4,4,4,4,4,4,6,6,6,6,6,6,6,6,6,6,6,6
8,8,8,8,8,8,8,8,8,8,8,8,8,8,8,8,8,8,8
,,,1,1,1,1,1,1,1,3,4,5,6,6,6,6,6,6
10,10,10,10,10,10,10,10,10,10,10,10,10,10,10,10,10,10,10
12,12,12,12,12,12,12,12,12,12,12,12,12,12,12,12,12,12,12
1,1,1,1,1,1,1,1,1,2,2,2,2,2,2,2,2,2,2
5,5,5,5,5,5,5,5,5,5,5,5,5,5,5,5,5,5,5
2,2,2,2,2,2,2,2,2,2,2,3,4,4,4,4,4,4,4
